3 8 2647 113 3634 3346 3622 1335 2706 2805 
3 11 2805 3580 2140 2999 3557 3114 1356 5181 501 3512 148 
3 5 3643 1391 194 1794 1104 
3 3 3643 141 1301 
3 9 1422 1846 1813 3099 1936 3615 3621 1394 1104 
3 2 1813 3622 
3 2 1422 2805 
3 12 1301 3625 572 1498 1811 237 6 1530 2294 359 3154 1422 
3 5 3634 383 250 2361 3630 
3 6 148 2939 2345 625 2842 3480 
3 13 3480 1624 3471 2234 3462 565 3456 907 3458 2864 2241 755 3042 
3 9 148 1404 95 2899 3518 3516 3524 581 2489 
3 8 1113 3602 3236 1751 1908 2482 544 1301 
3 3 1908 2640 920 
3 3 3236 437 920 
3 6 920 3637 1075 2977 3661 1975 
3 4 1975 241 2072 972 
3 5 972 2497 3674 2487 2178 
3 3 3603 3611 1113 
3 5 474 3656 2792 3654 4138 
3 8 4138 872 2103 108 3013 1195 2341 3603 
3 5 3603 1453 1641 620 1928 
3 3 1928 1724 680 
3 7 680 2416 3378 1125 2510 102 1975 
3 8 474 3671 3672 433 3302 1829 2078 680 
3 6 1809 3200 238 2632 1976 680 
3 5 1809 3200 3004 2837 2132 
3 4 2132 3738 3052 816 
3 3 1545 3181 3190 
3 4 1975 2891 1022 1545 
3 2 3190 3052 
3 7 2879 3710 1507 3689 2071 3134 972 
3 4 816 3734 1632 1336 
3 7 1336 3364 3091 3741 731 3740 1931 
3 9 1809 1442 316 880 2734 679 441 3708 2779 
3 6 2779 3692 941 586 1992 474 
3 7 3559 145 2444 608 2244 1223 1973 
3 9 1973 2995 185 1770 3274 844 2988 4184 915 
3 6 915 2190 2868 1252 2422 1990 
3 5 1990 3691 3701 2269 2779 
3 5 2559 3700 2425 3679 2781 
3 2 2917 2781 
3 3 3687 2799 2559 
3 5 2178 3683 1375 1377 3687 
3 3 3687 3684 2917 
3 7 3687 3262 1986 2381 3664 2504 3643 
3 6 3671 2124 1934 636 3248 1809 
3 7 3200 1832 1502 3298 499 1230 1975 
3 5 1336 1412 770 1307 2497 
3 6 2497 3233 2265 2639 3632 1301 
3 5 972 2471 1262 1199 3632 
3 6 2178 3261 647 1642 3739 3091 
3 6 3687 2147 2930 1919 2940 731 
3 2 2879 816 
3 5 2879 2059 3331 770 2178 
3 4 2178 5183 1239 3664 
3 5 1931 167 1446 3706 2559 
