3 8 2647 113 3634 3346 3622 1335 2706 2805 
3 11 2805 3580 2140 2999 3557 3114 1356 5181 501 3512 148 
3 5 3643 1391 194 1794 1104 
3 3 3643 141 1301 
3 9 1422 1846 1813 3099 1936 3615 3621 1394 1104 
3 2 1813 3622 
3 2 1422 2805 
3 12 1301 3625 572 1498 1811 237 6 1530 2294 359 3154 1422 
3 5 3634 383 250 2361 3630 
3 6 148 2939 2345 625 2842 3480 
3 13 3480 1624 3471 2234 3462 565 3456 907 3458 2864 2241 755 3042 
3 9 148 1404 95 2899 3518 3516 3524 581 2489 
3 8 1113 3602 3236 1751 1908 2482 544 1301 
3 3 1908 2640 920 
3 3 3236 437 920 
3 6 920 3637 1075 2977 3661 1975 
3 4 1975 241 2072 972 
3 5 972 2497 3674 2487 2178 
3 3 3603 3611 1113 
3 5 474 3656 2792 3654 4138 
3 8 4138 872 2103 108 3013 1195 2341 3603 
3 5 3603 1453 1641 620 1928 
3 3 1928 1724 680 
3 7 680 2416 3378 1125 2510 102 1975 
3 8 474 3671 3672 433 3302 1829 2078 680 
3 6 1809 3200 238 2632 1976 680 
3 5 1809 3200 3004 2837 2132 
3 4 2132 3738 3052 816 
3 3 1545 3181 3190 
3 4 1975 2891 1022 1545 
3 2 3190 3052 
3 7 2879 3710 1507 3689 2071 3134 972 
3 4 816 3734 1632 1336 
3 7 1336 3364 3091 3741 731 3740 1931 
3 9 1809 1442 316 880 2734 679 441 3708 2779 
3 6 2779 3692 941 586 1992 474 
3 7 3559 145 2444 608 2244 1223 1973 
3 9 1973 2995 185 1770 3274 844 2988 4184 915 
3 6 915 2190 2868 1252 2422 1990 
3 5 1990 3691 3701 2269 2779 
3 5 2559 3700 2425 3679 2781 
3 2 2917 2781 
3 3 3687 2799 2559 
3 5 2178 3683 1375 1377 3687 
3 3 3687 3684 2917 
3 7 3687 3262 1986 2381 3664 2504 3643 
3 6 3671 2124 1934 636 3248 1809 
3 7 3200 1832 1502 3298 499 1230 1975 
3 5 1336 1412 770 1307 2497 
3 6 2497 3233 2265 2639 3632 1301 
3 5 972 2471 1262 1199 3632 
3 6 2178 3261 647 1642 3739 3091 
3 6 3687 2147 2930 1919 2940 731 
3 2 2879 816 
3 5 2879 2059 3331 770 2178 
3 4 2178 5183 1239 3664 
3 5 1931 167 1446 3706 2559 
3 9 3285 3815 3310 3216 2671 2634 3802 2957 1337 
3 6 2957 2941 3797 3803 2571 3163 
3 7 3163 3810 3362 1867 2485 2588 2141 
3 5 2141 1435 2011 368 3240 
3 7 3835 2300 3851 739 2117 3023 2141 
3 4 3835 899 3071 874 
3 10 3240 1565 3363 919 961 732 2227 1723 2847 1120 
3 5 3850 1201 1137 3844 692 
3 8 1723 1851 1317 2901 3837 379 3829 692 
3 3 1120 2461 3850 
3 8 3850 2761 3050 1383 2174 1222 2648 874 
3 11 2141 3830 1830 3149 3227 3305 3847 2246 3322 3836 2408 
3 4 1337 3780 700 2408 
3 4 3285 3828 3840 3321 
3 16 3321 3356 3868 2170 3888 3062 3224 11 1319 2932 3908 2661 1748 2843 2197 2101 
3 9 2101 3289 1053 1862 3905 2728 960 3904 1657 
3 6 1657 3069 3375 1788 2669 1955 
3 7 3050 3883 372 508 3872 2673 1955 
3 13 1657 808 3937 2704 118 2987 2526 1771 1495 3949 3938 3075 3138 
3 8 1675 80 1664 4016 2703 475 1214 3138 
3 9 1657 3924 3948 2889 1763 3978 3022 1704 1789 
3 13 4061 1048 2959 2276 4053 4042 348 4023 2281 2337 4014 1338 1789 
3 15 1396 4150 3176 2221 2169 4151 2759 3165 4155 3160 2217 1066 2016 394 3251 
3 12 1675 4086 1410 2074 2435 4108 2286 615 2528 1700 4149 1396 
3 11 692 2372 1877 1981 2817 3153 390 1956 1051 1717 1990 
3 3 2269 2586 390 
3 9 1809 1442 2522 2961 2785 2772 1606 2945 2372 
3 3 3850 1038 1317 
3 4 1851 2537 2549 1809 
3 7 1809 1684 3229 2909 374 3059 1565 
3 7 3240 3793 3105 3774 3760 3748 816 
3 8 816 3748 3350 2128 447 2095 3823 2141 
3 7 1336 1762 2622 1473 3798 476 2588 
3 6 3163 1469 3786 2773 1604 3364 
3 4 3797 2323 2809 2773 
3 4 1473 3781 3777 1469 
3 8 731 1415 2790 3761 57 984 1746 2634 
3 9 3804 3795 1705 3196 2610 1154 3744 977 1931 
3 2 3804 3310 
3 4 1746 1300 1514 3804 
3 6 3321 2026 2070 2429 650 2957 
3 10 3163 2755 1826 2408 2375 2033 3843 2082 3304 3321 
3 5 3321 3370 2193 3319 4282 
3 10 2910 3994 2885 2024 2992 3965 3952 2107 1267 1319 
3 6 1319 3882 2786 1561 2745 2408 
3 16 2910 3169 3315 1231 3956 2367 2229 2908 3929 2722 3909 1618 3379 3874 1886 3319 
3 6 3810 932 3826 3167 234 3227 
3 4 3227 1060 3204 2101 
3 16 2101 3195 2996 973 2483 2980 3977 3987 3991 1005 2010 3366 4007 3035 4002 2910 
3 9 4061 1064 2627 1905 4024 2508 4025 2347 2910 
3 8 2141 3846 1925 2903 1836 2125 2371 1657 
3 7 899 2405 3871 3375 3069 3921 3937 
3 17 4177 4178 3089 1398 4167 964 4168 2913 2251 2815 4126 3205 4116 3146 360 1048 4061 
3 7 4193 4180 1612 3251 1352 4172 4177 
3 14 4177 1389 2849 2144 4147 1185 4117 4102 4085 1964 4048 2268 4018 1789 
3 10 2101 3195 2490 3942 2250 3962 876 2602 3119 1789 
3 17 394 4146 1028 4114 3249 2808 2166 4047 1918 4020 3170 2009 3975 3966 1966 1264 3924 
3 3 3240 3031 3835 
3 9 3138 1535 4009 4028 446 4066 1859 4127 1396 
3 6 3850 2761 2433 1631 3950 3138 
3 15 1396 4128 2395 3185 3211 2897 4075 4058 724 2529 1098 3983 3968 2202 3937 
3 17 1066 4144 4139 2835 4118 2737 1540 2457 4058 2238 2204 3999 517 3273 2321 1535 3138 
3 11 692 2325 3857 1796 1257 1151 2330 1596 2248 3316 3138 
3 11 1675 1663 2620 1055 1791 2692 2330 1151 3115 3864 3844 
3 5 1151 3344 3881 1776 3850 
3 5 1396 3377 4187 2062 4206 
3 6 2062 4204 3217 2343 4213 1790 
3 15 1790 2055 4210 1397 4207 4208 2583 2418 3116 4202 4197 4199 2297 2746 4193 
3 3 4177 2877 4291 
3 2 4193 2724 
3 5 1790 4214 4222 4223 4225 
3 22 4226 2387 4229 4227 3314 2464 4237 759 3003 4243 4244 2776 2386 4241 4240 3277 1895 4234 4231 355 3351 4225 
3 2 4226 4225 
3 28 4956 2491 4958 2985 3294 4959 2763 2854 4134 4964 2918 1173 1899 4179 2966 4170 4160 4135 426 4107 4091 3129 4072 4954 4056 2727 2839 4957 
3 2 4956 4957 
1 23 2287 795 758 1480 1304 3819 2041 955 2832 75 3028 1046 2762 428 1903 1024 2874 308 2503 2516 562 1549 1990 
1 5 1926 1777 1810 406 1888 
1 6 1888 48 850 1114 648 2240 
1 10 2240 202 3600 676 3592 942 3595 1062 643 145 
1 8 1536 421 3531 1000 165 859 1568 3559 
1 7 1000 322 2937 457 363 2572 542 
1 20 1973 754 3567 3143 2515 666 3589 2604 1950 3608 1493 3162 93 2089 1906 3184 1079 3616 2049 108 
1 7 1252 1509 1743 3673 1858 787 941 
1 14 3236 626 2687 424 3353 667 123 1750 1438 1041 3564 1499 3584 416 
1 7 416 2986 2156 2678 1914 3556 1757 
1 9 3480 1712 5178 2699 3505 1974 3125 3548 1757 
1 8 148 3053 1037 3479 2417 3459 2948 3441 
1 17 3630 429 435 3617 639 64 2720 1735 3588 3334 2118 3572 3021 3358 737 3540 3524 
1 10 3114 2791 3183 1625 3562 2679 3572 1243 1997 3570 
1 8 2805 1325 833 1897 806 3587 2621 1735 
1 5 3557 2050 1708 3583 1735 
1 5 2805 951 3612 429 3630 
1 9 3540 3524 2421 3506 668 2994 2447 2758 1786 
1 9 2489 3520 3511 1124 3504 1384 3493 3488 507 
1 11 3480 2591 1370 3226 1278 4952 3436 3110 1582 3421 1504 
1 9 1914 2575 887 2545 1959 2277 2443 3030 2234 
1 6 1675 4057 551 4037 707 1363 
1 5 1363 1086 3005 2754 2319 
1 7 1675 1433 2143 3330 2179 4163 2111 
1 3 1410 3082 4161 
1 12 692 3324 1559 3875 839 2146 3943 2771 2454 2711 3347 4057 
1 3 2781 2599 1263 
1 5 909 2393 1255 229 3324 
3 9 2482 1587 1138 1958 1498 3614 203 3629 1794 
3 2 1199 544 
